ui AbsolutePanel: ui.AbsolutePanel Reference
ui Button: ui.Button Reference
ui ButtonBase: ui.ButtonBase Reference
ui CellFormatter: ui.CellFormatter Reference
ui CellPanel: ui.CellPanel Reference
ui CheckBox: ui.CheckBox Reference
ui ClickDelegatePanel: ui.ClickDelegatePanel Reference
ui ComplexPanel: ui.ComplexPanel Reference
ui Composite: ui.Composite Reference
ui DeckPanel: ui.DeckPanel Reference
ui DialogBox: ui.DialogBox Reference
ui DockPanel: ui.DockPanel Reference
ui DockPanelTmpRow: ui.DockPanelTmpRow Reference
ui Event: ui.Event Reference
ui EventObject: ui.EventObject Reference
ui FileUpload: ui.FileUpload Reference
ui FlexCellFormatter: ui.FlexCellFormatter Reference
ui FlexTable: ui.FlexTable Reference
ui FlowPanel: ui.FlowPanel Reference
ui Focus: ui.Focus Reference
ui FocusListener: ui.FocusListener Reference
ui FocusPanel: ui.FocusPanel Reference
ui FocusWidget: ui.FocusWidget Reference
ui FormPanel: ui.FormPanel Reference
ui FormSubmitCompleteEvent: ui.FormSubmitCompleteEvent Reference
ui FormSubmitEvent: ui.FormSubmitEvent Reference
ui Frame: ui.Frame Reference
ui Grid: ui.Grid Reference
ui HTML: ui.HTML Reference
ui HTMLPanel: ui.HTMLPanel Reference
ui HTMLTable: ui.HTMLTable Reference
ui HasAlignment: ui.HasAlignment Reference
ui HasHorizontalAlignment: ui.HasHorizontalAlignment Reference
ui HasVerticalAlignment: ui.HasVerticalAlignment Reference
ui Hidden: ui.Hidden Reference
ui HorizontalPanel: ui.HorizontalPanel Reference
ui Hyperlink: ui.Hyperlink Reference
ui Image: ui.Image Reference
ui KeyboardListener: ui.KeyboardListener Reference
ui Label: ui.Label Reference
ui LayoutData: ui.LayoutData Reference
ui ListBox: ui.ListBox Reference
ui MenuBar: ui.MenuBar Reference
ui MenuBarPopupPanel: ui.MenuBarPopupPanel Reference
ui MenuItem: ui.MenuItem Reference
ui MouseListener: ui.MouseListener Reference
ui NamedFrame: ui.NamedFrame Reference
ui Panel: ui.Panel Reference
ui PasswordTextBox: ui.PasswordTextBox Reference
ui PopupPanel: ui.PopupPanel Reference
ui RadioButton: ui.RadioButton Reference
ui RootPanelCls: ui.RootPanelCls Reference
ui RootTreeItem: ui.RootTreeItem Reference
ui RowFormatter: ui.RowFormatter Reference
ui ScrollPanel: ui.ScrollPanel Reference
ui SimplePanel: ui.SimplePanel Reference
ui StackPanel: ui.StackPanel Reference
ui TabBar: ui.TabBar Reference
ui TabPanel: ui.TabPanel Reference
ui TextArea: ui.TextArea Reference
ui TextBox: ui.TextBox Reference
ui TextBoxBase: ui.TextBoxBase Reference
ui Tree: ui.Tree Reference
ui TreeContentPanel: ui.TreeContentPanel Reference
ui TreeItem: ui.TreeItem Reference
ui UIObject: ui.UIObject Reference
ui VerticalPanel: ui.VerticalPanel Reference
ui Widget: ui.Widget Reference
